111111111111
100P0C111111
110000000001
110000101111
110000C1C111
11C000000111
110000000111
110000000111
1100C000E111
111111111111
